AUD - Australian dollar
BGN - Bulgarian lev
BRL - Brazilian real
CAD - Canadian dollar
CHF - Swiss franc
CNY - Renminbi (Chinese) yuan
CZK - Czech koruna
DKK - Danish krone
EUR - Euro
GBP - Pound sterling
HKD - Hong Kong dollar
HRK - Croatian kuna
HUF - Hungarian forint
IDR - Indonesian rupiah
ILS - Israeli new shekel
INR - Indian rupee
ISK - Icelandic kr?na
JPY - Japanese yen
KRW - South Korean won
MAD - Moroccan dirham
MXN - Mexican peso
MYR - Malaysian ringgit
NOK - Norwegian krone
NZD - New Zealand dollar
PHP - Philippine peso
PLN - Polish z?oty
RON - Romanian leu
RUB - Russian ruble
SEK - Swedish krona
SGD - Singapore dollar
THB - Thai baht
USD - United States dollar
ZAR - South African rand
